15
20
0 1 6 6 6 6 6 6 6 6 6 6 6 6 6 6 6 6 2 0
4 7 7 7 7 7 7 7 7 7 7 7 7 7 7 7 7 7 7 4
3 7 7 7 7 7 7 7 7 7 7 7 7 7 7 7 7 7 7 3
3 7 7 7 7 7 7 7 7 7 7 7 7 7 7 7 7 7 7 3
3 7 7 7 7 7 7 7 7 7 7 7 7 7 7 7 7 7 7 3
3 7 7 7 7 7 7 7 7 7 7 7 7 7 7 7 7 7 7 3
3 7 7 7 7 7 7 7 7 7 7 7 7 7 7 7 7 7 7 3
3 7 7 7 7 7 7 7 7 7 7 7 7 7 7 7 7 7 7 3
3 7 7 7 7 7 7 7 7 7 7 7 7 7 7 7 7 7 7 3
3 7 7 7 7 7 7 7 7 7 7 7 7 7 7 7 7 7 7 3
3 7 7 7 7 7 7 7 7 7 7 7 7 7 7 7 7 7 7 3
3 7 7 7 7 7 7 7 7 7 7 7 7 7 7 7 7 7 7 3
3 7 7 7 7 7 7 7 7 7 7 7 7 7 7 7 7 7 7 3
5 7 7 7 7 7 7 7 7 7 7 7 7 7 7 7 7 7 7 5
0 1 6 6 6 6 6 6 6 6 6 6 6 6 6 6 6 6 2 0