15
30
0   0   0   0   0   0   0   0   0   0   0   0   0   0   0   0   0   0   0   0   0   0   0   0   0   0   0   0   0   0
0   0   0   0   0   0   0   0   0   0   0   0   0   0   0   0   0   0   0   0   0   0   0   0   0   0   0   0   0   0
0   0   0   0   0   0   0   0   0   0   0   0   0   0   0   0   0   0   0   0   0   0   0   0   0   0   0   0   0   0
0   0   0   0   0   0   0   0   0   0   0   0   0   0   0  15   0  15   0  15   0  15   0  15   0  15   0   0   0   0
0   0   0   0   0   0   0   0   0   0   0   0   0   0   0  15  15  15  15  15  15  15  15  15  15  15   0   0   0   0
0   0   0   0   0   0   0   0   0   0   0   0   0   0   0  15  15  15  15  15  15  15  15  15  15  15   0   0   0   0
0   0   0   0   0   0   0   0   0   0   0   0   0   0   0  15  15  15  15  15  15  15  15  15  15  15   0   0   0   0
0   0   0   0   0   0   0   0   0   0   0   0   0   0   0  15  15  15  15  15  15  15  15  15  15  15   0   0   0   0
0   0   0   0   0   0   0   0  31   0   0   0   0   0   0  15  15  15  15  15  15  15  15  15  15  15   0   0   0   0
0   0   0   0   0   0   0   0   0  31  31  31  31   0   0  15  15  15  15  15  15  15  15  15  15  15   0   0   0   0
0   0   0   0   0   0   0  31   0   0   0   0   0   0   0  15  15  15  15  15  15  15  15  15  15  15   0   0   0   0
0   0   0   0   0   0   0   0   0   0   0   0   0   0   0  15  15  15  15  15  15  15  15  15  15  15   0   0   0   0
0   0   0   0   0   0   0   0   0   0   0   0   0   0   0  15  15  15  15  15  15  15  15  15  15  15   0   0   0   0
26 26  26  26  26  26  26  26  26  26  26  26  26  26  26  26  26  26  26  26  26  26  26  26  26  26  26  26  26  26
36 36  36  36  36  36  36  36  36  36  36  36  36  36  36  36  36  36  36  36  36  36  36  36  36  36  36  36  36  36